***XXXX****X********XXXX
XX******XX*X*XXXXXX*XXXX
XX*XXXX*XX*X*X*******XXX
XX*XXXX*XX*X*X*XXX*XXXXX
XX******XX***X******XXXX
XXXXXXXXXXXXXXXXXXX***X*