***XXXX****X********XXXX
XX******XX*X*XXXXXX*XXXX
XX*XXXX*XX*X*X******XXXX
XX*XXXX*XX*X*X*XXX*XXXXX
XX******XX***X******XXXX
XXXXXXXXXXXXXXXXXXX*****